32
16

[
----------------------------------|
-                                -|
-  P                             -|
----                     --     --|
-            --                  -|
-                                -|
-                                -|
]