16
24

[
----------------------------------|
-                         P      -|
-                                -|
----                     --     --|
-            --                  -|
-                                -|
-                                -|
-                                -|
-----                            -|
-----            --              -|
]